█████████████████████████████
█           █               █
█  $        █                
█           ████████        █
█       █                   █
█       █           Z       █
█   H   █                   █
█████████████████████████████
                             