████████████████ ██████████
█   $   █       H         █
█       █   █             █
█   X   █   █   ███████████
████ ████   █     X       █
█           █             █
███████████████████████ X █
█   STORE   █             █
█                         █
█           █      ████████
█           █     X        
███████████████████████████