████████████████H██████████
█   $   █                 █
█       █   █             █
█   X   █   █   ███████████
████ ████   █     X       █
█           █             █
███████████████████████ X █
█   STORE   █             █
█                         █
█           █      ████████
█  A  A  A  █     X        
███████████████████████████
A = Potion ($15)