████████████████H██████████
█   $   █                 █
█       █   █             █
█   X   █   █Å  Å██████████
████ ████   █     X       █
█          Å█             █
███████████████████████ X █
█   STORE   █             █
█                         █
█           █      ████████
█  A  A  A  █     X        
███████████████████████████
A = Potion ($15)